Road To The Riches | Kool G Rap & DJ Polo
Warm It Up Kane | Big Daddy Kane
The Godfather | Spoonie Gee
Me & The Biz | Masta Ace
Children's Story | Slick Rick
Rebel Without A Pause | Public Enemy
I Know You Got Soul | Eric B. & Rakim
It Takes Two | Rob Base & D.J. EZ Rock
B.Y.S. | Gang Starr
The Vapors | Biz Markie
Brand Nubian | Brand Nubian
Critical Beatdown | Ultramagnetic Mc's
I  Don't  Give a Fuck  | 2 Pac
Hood Took Me Under | Compton's Most Wanted
Nuthin' But A "G" Thang | Dr.Dre
The Ghetto | Too Short
Alwayz Into Somethin' | NWA
Check Yo Self (The Message Remix) | Ice Cube
La Raza | Kid Frost
How Could I Just Kill A Man | Cypress Hill
Fuck Wit Dre Day | Dr.Dre
It's Funky Enough | The D.O.C.
Express Yourself | NWA
It Was A Good Day | Ice Cube
Eazy-Er Said Than Dunn | Eazy E
Murder Rap | Above The Law
Deep Cover | Dr.Dre
Guerillas In Tha Mist | Da Lench Mob
I Can Make You Dance | Zapp
Hollywood Swingin' | Kool And The Gang
Love Rollercoaster | Ohio Players
Cold Blooded | Rick James
Twilight | Maze
Yum Yum | Fatback
Between The Sheets | The Isley Brothers
West Coast Poplock | Ronnie Hudson
Fantastic Voyage | Lakeside
Loopzilla | George Clinton
Let It Whip | Dazz Band
Candy | Cameo
Love Is the Message | MFSB
Funky Worm | Ohio Players
Odyssey | Johnny Harris
Running Away | Roy Ayers
You Dropped A Bomb On Me | The Gap Band
Amos Moses | Jerry Reed
Louisiana Woman,Mississippi Man | Conway Twitty & Loretta Lynn
Hey Good Lookin' | Hank Williams
Queen Of Hearts | Juice Newton
New York City | Statler Bros.
The Letter That Johnny Walker Read | Asleep At The Wheel
One Step Forward | The Desert Rose Band
Crazy | Willie Nelson
Three Cigarettes In The Ashtray | Pasty Cline
Bed Of Roses | Statler Bros.
Make The World Go Away | Micky Gilley
Mama Don't Let Your Babies Grow Up To Be Cowboys | Ed Bruce
Always Wanting You | Merle Haggard
All My Exes Live In Texas | Whitey Shafer
I Love A Rainy Night | Eddie Rabbit
Slow Ride | Foghat
Green River | Creedence Clearwater Revival
Barracuda | Heart
Strutter | Kiss
Hold The Line | Toto
Young Turks | Rod Stewart
Running Down A Dream | Tom Petty
Woman To Woman | Joe Cocker
Get Down To It | Humble Pie
Some Kind Of Wonderful | Grand Funk Railroad
Free Bird | Lynyrd Skynyrd
A Horse With No Name | America
Eminence Front | The Who
Smokin' | Boston
Somebody Up There Likes Me | David Bowie
Two Tickets To Paradise | Eddie Money
White Wedding | Billy Idol
Make My Body Rock | Jomanda
Pacific | 808 State
Weekend | The Todd Terry Project
Let The Music(Use You) | Nightwriters
Move Your Body | Marshall Jefferson
This Is Acid | Maurice
Can You Feel It? | Mr.Fingers
Voodoo Ray | A Guy Called Gerald
Ma Foom Bey | Cultural Vibe
Someday | Ce Ce Rogers
I'll Be Your Friend | Robert Owens
Your Love | Frankie Knuckles
Promised Land | Joe Smooth
I Need A Rythm | 28th Street Crew
Break 4 Love | Raze
The Morning After | Fallout
Don't Let It Go To Your Head | Black Harmony
Ring My Bell | Blood Sisters
Wicked Inna Bed | Shabba Ranks
Batty Rider | Buju Banton
King Tubby Meets The Rockers Uptown | Augustus Pablo
Revolution | Dennis Brown
Armagideon Time | Willie Williams
Sidewalk Killer | I Roy
Funky Kingston | Toots & The Maytals
Cocaine My Brain | Dillinger
Pressure Drop | The Maytals
Bam Bam | The Pliers
Here I Come | Barrington Levy
Drum Pan Sound | Reggie Stepper
Great Train Robbery | Black Uhuru
Chase The Devil | Max Romeo & The Upsetters
I'm So Into You | SWV
Keep On Movin' | Soul II Soul
So You Like What You See | Samuelle
My Lovin' (Never Gonna Get It) | En Vogue
Rub You The Right Way | Johnny Gill 
Sensitivity | Ralph Tresvant
Groove Me | Guy
Don't Be Afraid | Aaron Hall
Motownphilly | Boyz II Men
Poison | Bell Biv Devoe
I Got The Feeling | Today
New Jack Swing | Wrecks-N-Effect
Don't Be Cruel | Bobby Brown
The News With Lianne Forget | Lianne Forget & Richard Burns
The Tight End Zone | Derrick Thackery
The Wild Traveler | James Pedeaston
Entertaining America | Billy Dexter
Gardening With Maurice | Maurice
I Say/You Say | Peyton Phillips
Lonely Hearts Show | Christy Macintyre
Area 53 | Marvin Trill
Unsung | Helmet
Personal Jesus | Depeche Mode
Midlife Crisis | Faith No More
Mother | Danzig
Cult Of Personality | Living Colour
Movin' On Up | Primal Scream
Welcome To The Jungle | Guns N' Roses
Pretend We're Dead | L7
Hellraiser | Ozzy Osbourne
Rusty Cage | Soundgarden
Killing In The Name | Rage Against The Machine
Been Caught Stealing | Jane's Addiction
Fools Gold | The Stone Roses
Them Bones | Alice In Chains
Plush | Stone Temple Pilots
Express Yourself | Charles Wright
Cross The Tracks(We Better Go Back) | Maceo $ The Macks
Smokin' Cheeba Cheeba | Harlem Underground Band
Jungle Fever | The Chakachas
Natilus | Bob James
Green Onions | Booker T & The MGS
Rock Creek Park | The Blackbyrds
Hot Pants | Bobby Byrd
Funky President | James Brown
Rock Me Again And Again | Lyn Collins
Soul Power 74 | Maceo & The Macks
I Know You Got Soul | Bobby Byrd
The Payback | James Brown
Think About It | Lyn Collins
Grunt | The JB'S
Low Rider | War
Tainted Love | Gloria Jones
(I Got)So Much Trouble In My Mind | Sir Joe Quarterman & Free Soul